rumor - слухи
I'm afraid so - боюсь что именно так
wise - мудро
trust MEN with SMTH - доверять кому-то что-либо
tyke - малыш
fell asleep - заснуть
worst - нахудший
better off - лучше 
after all - в конце концов
get up - вставай
Hurry up - быстро   
darling - dear
how is that - как тебе это 
funny business - подозрительное дело 
meal - еда
Get in - залезть
sorry about him - не сердись на него 
lying - лежать 
press - навязывать 
It's just - просто 
talk to - разгвоаривать с кем-то 
as well - так же 
either - оба, любую 
Anytime - пожалуйста
sweetheart - золотце
get you out - вытащить 
swear - клясться
whelk - прыщ (ate a funny whelk?)
have a lovely day - удачного дня
got on - прочь отсюда  
Right you are - Вот именно
blasted - проклятых
not one - ни одного 
make it stop - прекратите это
get off - прочь
make a wish - загадывать желание 
demand - требую
at once - сразу 
Dry up - остынь 
prune - болван
bit more along - вырасти 
particularly - особенно 
wager - держу пари 
pleased - рады 
accept - пригласить 
rubbish - чушь
all along - все время 
proud - гордились
abnormal - ненормальный
blown up - прихлопнуть
got landed - оказываешься 
outrage - возмутительно 
folk - народ
headmaster - директор 
crackpot - сумасшедший 
fool - старикан
insult - оскорблять 
appreciate - ценить\признателен
not allowed to - нельзя
behinde schedule - отставать от графика 
Best be off - лучше поторопиться 
unless - если 
rather - предпочитать 
pewter - оловянный 
cauldron - котел 
desire - желать 
owl - сова 
toad - жаба 
presume - предпологать 
supplies - принадлежности  
Bless my soul - благослови мою душу 
at last - наконец-то 
against - против 
fearfully - крайне 
fascinating - увлекательный 